\-~~#####----~~~-#--/
--#~#-----#-###--##--
-##-#-##-#~~~~-#---#~
-##-~~##~--##-#-##-#~
--##-~~~~-#---~~~~-#~
#----#-#--#-#-#-#~##~
#-##----~~~~#---#-~#-
###-##-##-#-#-#---~~-