\-~~#####----~~~-#--/
--#~#-----#-###--##--
-##-#-##-#~~~~-#---#-
~##--~##~--##~#-##-#-
~~##-~~~~-#---#~~~-#~
#----#-##-#-#-#-#~##~
#-#-##--~~~~#---#--#~
###-##-##-#-#-#------