\-~~~#######----~~~~-#--/
---#-#----#--#-###---##--
-#-#-#-##-#-#~~~~-##---#-
~#-#--~##~----##~#-###-#-
~~~##-~~~~#--#---#~~~#-#~
#-~~--#-###--#-#-#-#~#-#~
#--#-##----~~~~#---#~--#~
##-#-##-##-###-#-#---#---
##---~~~##-----~~--#-#-#-
#######~~~~#####~~~------